	
 C     9, 		89, 	150
	WE ./textures/west.xpm
 NO ./textures/north.xpm
  SO   ./textures/south.xpm
EA ./textures/east.xpm
  F 26, 23, 37

11111111111111111111
10001N10000000000001		111
11111111111111111111        101
111111111111111111111111111111111    
									1
									1
									1
									1
									1
